#########################################################################################################################################################################################
#########################################################################################################################################################################################
##..........................#........................#................#...............#................#.........................#.........................#...........................##
##..........................#........................#................#...............#................#.........................#.........................#...........................##
##..........................#........................#................#...............#................#.........................#.........................#...........................##
##..........................#........................#................#...............#................#.........................#.........................#...........................##
##..........................#........................#................#...............#................#.........................#.........................#...........................##
##.......................................#...........#................#...............#................#.........................#.........................#...........................##
##.......................................#...........#................#...............#................#.........................#.........................#...........................##
##.......................................#...........#................#...............#................#.........................#.........................#...........................##
##..........................#............#...........#................#...............#................#.........................#.........................#...........................##
##..........................#............#...........#................#...............#................#.........................#.........................#...........................##
#############################............#...........#................#...............#................#.........................#.........................#...........................##
##............#..........................#...........#................#...............#................#.........................#.........................#...........................##
##............#..........................#...........#................#...............#................#.........................#.........................#...........................##
##............#..........................#...........#................#...............#................#.........................#.........................#...........................##
##.......................................#...........#................#...............#................#.........................#.........................#...........................##
##.......................................#...........#................#...............#................#.........................#.........................#...........................##
##.......................................#...........#................#...............#................#.........................#.........................#...........................##
##............#..........................#...........#................#...............#................#.........................#.........................#...........................##
##............#..........................#...........#................#...............#................#.........................#.........................#...........................##
##............#..........................#...........#................#...............#................#.........................#.........................#...........................##
###############....###########...........#...........#................#...............#................#.........................################..........#...........................##
##.................#....#....#...........#...........#................#...............#................#.........................#..............#..........#...........................##
##.................#....#....#...........#############................#...............#................#.........................#..............#..........#...........................##
##.................#....#....#.......................#................#...............#................#.........................#.........................#...........................##
##.................#....#....#.......................#................#...............#................#.........................#.........................#...........................##
##.................#....#....#.......................#................#...............#................#.........................#.........................#...........................##
##.................#.................................####....###########....###############...##############...#####################################...#######...########################
##.................#...................................................................................................................................................................##
##.................#...................................................................................................................................................................##
##############################.........................................................................................................................................................##
##...........................#.........................................................................................................................................................##
##...........................#.........................................................................................................................................................##
##...........................#.........................................................................................................................................................##
##...........................#.........................................................................................................................................................##
##............................................########...############...#####################...######################...........###############....###############...###################
##............................................#.................#..............#.....................................#...........#........................#............................##
##............................................#.................#..............#.....................................#...........#........................#............................##
##############################................#.................#..............#.....................................#...........#........................#............................##
##...........................#................#.................#..............#.....................................#...........#........................#............................##
##...........................#................#.................#..............#.....................................#...........#........................#............................##
##............................................#.................#..............#.....................................#...........#........................#............................##
##............................................#.................#..............#.....................................#...........#........................#............................##
##............................................#.................#..............#.....................................#...........#........................#............................##
##...........................#................#.................#..............#.....................................#...........#........................#............................##
##...........................#................#.................#..............#.....................................#...........#........................#............................##
##...........................############...###.................#..............#.....................................#...........#........................#............................##
##...........................#................#.................#..............#.....................................#...........#........................#............................##
##...........................#................#.................#..............#.....................................#...........#........................#............................##
##...........................#................#.................#..............#.....................................#...........#........................#............................##
##...........................#................#.................#..............#.....................................#...........#........................#............................##
##...........................#................#.................#..............#.....................................#...........#........................#............................##
##...........................#................#.................#..............#.....................................#...........#........................#............................##
##...........................#................#.................#..............#.....................................#...........#........................#............................##
##...........................#................#.................#..............#.....................................#...........#........................#............................##
##...........................#................#.................#..............#.....................................#...........#........................#............................##
##...........................#................#.................#..............#.....................................#...........#........................#............................##
##...........................#................#.................#..............#.....................................#...........#........................#............................##
##...........................#................#.................#..............#.....................................#...........#........................#............................##
######################################################################################################################...........########################################################
########################################################################################################################.......##########################################################
                                                                                                      #...................................................#
                                                                                                       #..................................................#
                                                                                                        #.................................................#
                                                                                                         ##...............................................#
                                                                                                           ###............................................#
                                                                                                              ##########..................................#
                                                                                                                        ##########........................#
                                                                                                                                 #........................#
                                                                                                                                 #..................#######
                                                                                                                                 ###################